BBBBBBBBBBBB
BBBBBBBBBBBB
B        JBB
B         BB
B         BB
B         BB
B    E     B
B          B
B      E   B
BBBBBBBBBBBB
BBBBBBBBBBBB
BBBBBBBBBBBB